1111111111111111111111111111111111
100000000000000C00000C000000000001
1010011100100000101001000000010101
101001E010101010001001000000010101
1P0001110C00C000000000000000000C01
1111111111111111111111111111111111